12 12 12 12 12 12 12 12 12 12 12 12 12 12 12 12 12 12 12 12 12 12 12 12 12 12 12 12 12 12 12 12 12 12
12 12 12 12 12 12 12 12 12 12 12 12 12 12 12 12 12 12 12 12 12 12 12 12 12 12 12 12 12 12 12 12 12 12
12 12 12 12 12 12 12 12 12 12 12 12 12 12 12 12 12 12 12 12 12 12 12 12 12 12 12 12 12 12 12 12 12 12
12 12 12 12 12 12 12 12 12 12 12 12 12 12 12 12 12 12 12 12 12 12 12 12 12 12 12 12 12 12 12 12 12 12
00 01 01 01 01 01 01 01 01 01 01 01 01 01 01 01 02 00 01 01 01 01 01 01 01 01 01 01 01 01 01 01 01 02
03 12 12 12 12 12 12 12 12 12 12 12 12 12 12 12 04 03 12 12 12 12 12 12 12 12 12 12 12 12 12 12 12 04
03 12 12 12 12 12 12 12 12 12 12 12 12 12 12 12 04 03 12 12 12 12 12 12 12 12 12 12 12 12 12 12 12 04
03 12 12 23 06 06 24 12 12 23 06 06 06 24 12 12 04 03 12 12 23 06 06 06 24 12 12 23 06 06 24 12 12 04
03 12 12 04 12 12 03 12 12 04 12 12 12 03 12 12 04 03 12 12 04 12 12 12 03 12 12 04 12 12 03 12 12 04
03 12 12 21 01 01 22 12 12 21 01 01 01 22 12 12 21 22 12 12 21 01 01 01 22 12 12 21 01 01 22 12 12 04
03 12 12 12 12 12 12 12 12 12 12 12 12 12 12 12 12 12 12 12 12 12 12 12 12 12 12 12 12 12 12 12 12 04
03 12 12 12 12 12 12 12 12 12 12 12 12 12 12 12 12 12 12 12 12 12 12 12 12 12 12 12 12 12 12 12 12 04
03 12 12 23 06 06 24 12 12 23 24 12 12 23 06 06 06 06 06 06 24 12 12 23 24 12 12 23 06 06 24 12 12 04
03 12 12 21 01 01 22 12 12 04 03 12 12 21 01 01 02 00 01 01 22 12 12 04 03 12 12 21 01 01 22 12 12 04
03 12 12 12 12 12 12 12 12 04 03 12 12 12 12 12 04 03 12 12 12 12 12 04 03 12 12 12 12 12 12 12 12 04
03 12 12 12 12 12 12 12 12 04 03 12 12 12 12 12 04 03 12 12 12 12 12 04 03 12 12 12 12 12 12 12 12 04
05 06 06 06 06 06 24 12 12 04 05 06 06 24 12 12 04 03 12 12 23 06 06 07 03 12 12 23 06 06 06 06 06 07
12 12 12 12 12 12 03 12 12 04 00 01 01 22 12 12 21 22 12 12 21 01 01 02 03 12 12 04 12 12 12 12 12 12
12 12 12 12 12 12 03 12 12 04 03 12 12 12 12 12 12 12 12 12 12 12 12 04 03 12 12 04 12 12 12 12 12 12
12 12 12 12 12 12 03 12 12 04 03 12 12 12 12 12 12 12 12 12 12 12 12 04 03 12 12 04 12 12 12 12 12 12
12 12 12 12 12 12 03 12 12 04 03 12 12 23 06 06 06 06 06 06 24 12 12 04 03 12 12 04 12 12 12 12 12 12
01 01 01 01 01 01 22 12 12 21 22 12 12 04 12 12 12 12 12 12 03 12 12 21 22 12 12 21 01 01 01 01 01 01
12 12 12 12 12 12 12 12 12 12 12 12 12 04 12 12 12 12 12 12 03 12 12 12 12 12 12 12 12 12 12 12 12 12
12 12 12 12 12 12 12 12 12 12 12 12 12 04 12 12 12 12 12 12 03 12 12 12 12 12 12 12 12 12 12 12 12 12
06 06 06 06 06 06 24 12 12 23 24 12 12 04 12 12 12 12 12 12 03 12 12 23 24 12 12 23 06 06 06 06 06 06
12 12 12 12 12 12 03 12 12 04 03 12 12 21 01 01 01 01 01 01 22 12 12 04 03 12 12 04 12 12 12 12 12 12
12 12 12 12 12 12 03 12 12 04 03 12 12 12 12 12 12 12 12 12 12 12 12 04 03 12 12 04 12 12 12 12 12 12
12 12 12 12 12 12 03 12 12 04 03 12 12 12 12 12 12 12 12 12 12 12 12 04 03 12 12 04 12 12 12 12 12 12
12 12 12 12 12 12 03 12 12 04 03 12 12 23 06 06 06 06 06 06 24 12 12 04 03 12 12 04 12 12 12 12 12 12
00 01 01 01 01 01 22 12 12 21 22 12 12 21 01 01 02 00 01 01 22 12 12 21 22 12 12 21 01 01 01 01 01 02
03 12 12 12 12 12 12 12 12 12 12 12 12 12 12 12 04 03 12 12 12 12 12 12 12 12 12 12 12 12 12 12 12 04
03 12 12 12 12 12 12 12 12 12 12 12 12 12 12 12 04 03 12 12 12 12 12 12 12 12 12 12 12 12 12 12 12 04
03 12 12 23 06 06 24 12 12 23 06 06 06 24 12 12 04 03 12 12 23 06 06 06 24 12 12 23 06 06 24 12 12 04
03 12 12 21 01 02 03 12 12 21 01 01 01 22 12 12 21 22 12 12 21 01 01 01 22 12 12 04 00 01 22 12 12 04
03 12 12 12 12 04 03 12 12 12 12 12 12 12 12 12 12 12 12 12 12 12 12 12 12 12 12 04 03 12 12 12 12 04
03 12 12 12 12 04 03 12 12 12 12 12 12 12 12 12 12 12 12 12 12 12 12 12 12 12 12 04 03 12 12 12 12 04
05 06 24 12 12 04 03 12 12 23 24 12 12 23 06 06 06 06 06 06 24 12 12 23 24 12 12 04 03 12 12 23 06 07
00 01 22 12 12 21 22 12 12 04 03 12 12 21 01 01 02 00 01 01 22 12 12 04 03 12 12 21 22 12 12 21 01 02
03 12 12 12 12 12 12 12 12 04 03 12 12 12 12 12 04 03 12 12 12 12 12 04 03 12 12 12 12 12 12 12 12 04
03 12 12 12 12 12 12 12 12 04 03 12 12 12 12 12 04 03 12 12 12 12 12 04 03 12 12 12 12 12 12 12 12 04
03 12 12 23 06 06 06 06 06 07 05 06 06 24 12 12 04 03 12 12 23 06 06 07 05 06 06 06 06 06 24 12 12 04
03 12 12 21 01 01 01 01 01 01 01 01 01 22 12 12 21 22 12 12 21 01 01 01 01 01 01 01 01 01 22 12 12 04
03 12 12 12 12 12 12 12 12 12 12 12 12 12 12 12 12 12 12 12 12 12 12 12 12 12 12 12 12 12 12 12 12 04
03 12 12 12 12 12 12 12 12 12 12 12 12 12 12 12 12 12 12 12 12 12 12 12 12 12 12 12 12 12 12 12 12 04
05 06 06 06 06 06 06 06 06 06 06 06 06 06 06 06 06 06 06 06 06 06 06 06 06 06 06 06 06 06 06 06 06 07